111111111111111111
1000C0000000000011
110000000000010011
111111111101100011
10000C0000N0000011
101111111111101111
10C00C00000P000E11
111111111111111111